TILEMAP
22 11   							-- Size of tile map in tiles
32 32 							-- Tile size & block size
images/land.png 	-- Tilesheet
10 2							-- Number of tiles in tilesheet
0000000000000000000000
0000000000000001200000
0000000000000003400000
0000000000000003562000
1762000000000003554000
3555666066666665555662
3555555055555555555554
3555898088888885555554
A88B00000000000A888554
0000000000000000000A8B
0000000000000000000000