[BEGIN TILEMAP]
DIMENSIONS 22 18
TILE_SIZE 32
BLOCK_SIZE 32
TILESHEET images/land.png
TILESHEET_NUMTILES 10 2
[BEGIN TILES]
0000000000000000000000
0000000000000000000000
0000000000000000000000
00000000000000000CC0D0
0000000000000000166652
0000000000000EFF888854
0000000000000GGG000034
0000000000000000000034
0000000000000000000034
1666666666666FFFF67654
3555555555554000035554
A88888888888B0000A988B
0000000000000000000000
000000000EF20000000000
00000000000H0000000000
0000000000000000000000
0000000000000000000000
0000000000000000000000
[END TILES]
[END TILEMAP]

[BEGIN OBJECTS]
# TYPE ID(Unique or crash!) X Y FLIP
PLAYER 0 64 288 0
PLAYER 1 64 384 1
[END OBJECTS]

