TILEMAP
19 15   							-- Size of tile map in tiles
32 32 							-- Tile size & block size
images/land.png 	-- Tilesheet
10 2							-- Number of tiles in tilesheet
0000000000000000000
001200000CC00000000
0034000016662CC1662
1755666655555665554
A85888885555988888B
00K00000A88B0000000
00K0000000000000000
00KCC00000000000000
003FI00000000000000
00K0000000000000000
00K0000000000000000
00H0000000000000000
0000000000000000000
