TILEMAP
23 14   							-- Size of tile map in tiles
32 32 							-- Tile size & block size
images/land.png 	-- Tilesheet
10 2							-- Number of tiles in tilesheet
00000000000000000000000
000000000000000000CC0D0
00000000000000000166652
00000000000000EFF888854
00000000000000GGG000034
00000000000000000000034
00000000000000000000034
16666666666666FFFF67654
35555555555554000035554
A888888888888B0000A988B
00000000000000000000000
0000000000EF20000000000
000000000000H0000000000
00000000000000000000000