*1961010101010105**************************************
**1914999997**************************************
***1914999991010101045********************************
****191411111111115********************************
************************************************
********************310101010101010101010105***************
********************141111111111115***************
************************************************
34101010101010101010101010101045******************************
14111111111111111115******************************
************************************************
************************************************
************************************************
************************************************
************************************************
